across|ax k r oh s
actor|ae k t ax
adding|ae d ih ng
air|ea
along|ax l oh ng
always|ao l w ey z
and|ae n d
and|ax n d
apart|ax p aa t
are|aa
around|ax r aw n d
attacked|ax t ae k t
at|ax t
a|ax
background|b ae k g r aw n d
back|b ae k
badly|b ae d l iy
bail|b ey l
ball|b ao l
barn|b aa n
bay|b ey
beat|b iy t
beauty|b y uw t iy
before|b ih f ao
bell|b eh l
bent|b eh n t
beside|b ih s ay d
big|b ih g
bill|b ih l
bind|b ay n d
birch|b er ch
birth|b er th
blue|b l uw
boards|b ao d z
boat|b ow t
bonds|b oh n d z
books|b uh k s
booth|b uw dh
both|b ow th
bowls|b ow l z
box|b oh k s
boy|b oy
breeze|b r iy z
brim|b r ih m
broke|b r ow k
buses|b ah s ih z
bush|b uh sh
button|b ah t n
but|b ax t
came|k ey m
canoe|k ax n uw
cars|k aa z
car|k aa
case|k ey s
catch|k ae ch
cat|k ae t
chicken|ch ih k ih n
chicks|ch ih k s
china|ch ay n ax
chopped|ch oh p t
circus|s er k ax s
clear|k l ia
clock|k l oh k
closely|k l ow s l iy
close|k l ow z
cloud|k l aw d
coat|k ow t
colt|k ow l t
cooked|k uh k t
cool|k uw l
cop|k oh p
corn|k ao n
costly|k oh s t l iy
costs|k oh s t s
cow|k aw
crash|k r ae sh
creek|k r iy k
crooked|k r uh k ih d
cue|k y uw
cup|k ah p
curled|k er l d
cushion|k uh sh n
cut|k ah t
dark|d aa k
days|d ey z
deep|d iy p
depth|d eh p th
dirty|d er t iy
dish|d ih sh
dive|d ay v
door|d ao
draft|d r ae f t
dried|d r ay d
drifts|d r ih f t s
droopy|d r uw p iy
drug|d r ah g
dull|d ah l
dune|d y uw n
early|er l iy
easy|iy z iy
edge|eh jh
eggs|eh g z
ended|eh n d ih d
evening|iy v n ih ng
every|eh v r iy
faced|f ey s t
face|f ey s
factors|f ae k t ax z
failed|f ey l d
fall|f ao l
far|f aa
fast|f ae s t
fed|f eh d
feet|f iy t
fence|f eh n s
field|f iy l d
fifty|f ih f t iy
fight|f ay t
fine|f ay n
finished|f ih n ih sh t
fin|f ih n
fires|f ay ax z
firm|f er m
first|f er s t
fish|f ih sh
flame|f l ey m
floor|f l ao
flop|f l oh p
follow|f oh l ow
fool|f uw l
force|f ao s
for|f ax
four|f ao r
friendly|f r eh n d l iy
from|f r oh m
frosty|f r oh s t iy
fruit|f r uw t
fudge|f ah jh
full|f uh l
gang|g ae ng
garbage|g aa b ih jh
gas|g ae s
gave|g ey v
get|g eh t
gifts|g ih f t s
girl|g er l
glaring|g l ea r ih ng
glue|g l uw
gnawed|n ao d
go|g ow
grand|g r ae n d
grass|g r ae s
grease|g r iy s
hailed|hh ey l d
half|hh aa f
hardly|hh aa d l iy
hardware|hh aa d w ea
hard|hh aa d
hat|hh ae t
heart|hh aa t
heat|hh iy t
helps|hh eh l p s
help|hh eh l p
here|hh ia
her|hh er
he|hh iy
hikes|hh ay k s
hill|hh ih l
him|hh ih m
his|hh ih z
hit|hh ih t
hogs|hh oh g z
hoist|hh oy s t
hole|hh ow l
home|hh ow m
hook|hh uh k
hop|hh oh p
horn|hh ao n
hot|hh oh t
hours|aw ax z
huge|hh y uw jh
hung|hh ah ng
ink|ih ng k
inside|ih n s ay d
into|ih n t ax
in|ih n
is|ih z
its|ih t s
it|ih t
joy|jh oy
juice|jh uw s
june|jh uw n
keeps|k iy p s
kept|k eh p t
kick|k ih k
king|k ih ng
kittens|k ih t n z
lack|l ae k
lake|l ey k
large|l aa jh
late|l ey t
lawyer|l ao y ax
lay|l ey
lazy|l ey z iy
leads|l iy d z
lease|l iy s
leave|l iy v
left|l eh f t
leg|l eh g
lemons|l eh m ax n z
lift|l ih f t
limb|l ih m
limp|l ih m p
lives|l ay v z
living|l ih v ih ng
load|l ow d
lose|l uw z
lost|l oh s t
loud|l aw d
makes|m ey k s
make|m ey k
making|m ey k ih ng
mans|m ae n z
march|m aa ch
mark|m aa k
maze|m ey z
meal|m iy l
mend|m eh n d
men|m eh n
mesh|m eh sh
met|m eh t
more|m ao
morning|m ao n ih ng
mouse|m aw s
moved|m uw v d
navy|n ey v iy
near|n ia
next|n eh k s t
nice|n ay s
note|n ow t
no|n ow
off|oh f
often|oh f n
of|ax v
of|oh v
oiled|oy l d
once|w ah n s
on|oh n
order|ao d ax
out|aw t
over|ow v ax
page|p ey jh
paid|p ey d
pants|p ae n t s
parked|p aa k t
parts|p aa t s
passed|p ae s t
pass|p ae s
past|p ae s t
path|p ae th
pearl|p er l
peel|p iy l
pencil|p eh n s l
perfect|p ax f eh k t
period|p ia r ia d
pet|p eh t
pie|p ay
pink|p ih ng k
pins|p ih n z
place|p l ey s
planks|p l ae ng k s
playing|p l ey ih ng
play|p l ey
pleasure|p l eh zh ax
plunge|p l ah n jh
point|p oy n t
porch|p ao ch
post|p ow s t
pot|p oh t
pound|p aw n d
press|p r eh s
prone|p r ow n
punch|p ah n ch
pup|p ah p
purse|p er s
quite|k w ay t
raging|r ey jh ih ng
rained|r ey n d
rang|r ae ng
ran|r ae n
rare|r ea
reach|r iy ch
read|r iy d
reared|r ia d
reef|r iy f
response|r ih s p oh n s
rice|r ay s
rich|r ih ch
rider|r ay d ax
ring|r ih ng
river|r ih v ax r
road|r ow d
rod|r oh d
rope|r ow p
rose|r ow z
round|r aw n d
ruled|r uw l d
salmon|s ae m ax n
salt|s oh l t
same|s ey m
sand|s ae n d
saw|s ao
scared|s k ea d
season|s iy z n
sea|s iy
seems|s iy m z
see|s iy
seized|s iy z d
seldom|s eh l d ax m
sell|s eh l
served|s er v d
set|s eh t
seven|s eh v n
sew|s ow
sharp|sh aa p
sheet|sh iy t
shimmered|sh ih m ax d
ship|sh ih p
short|sh ao t
shoulder|sh ow l d ax
show|sh ow
sickness|s ih k n ax s
side|s ay d
silver|s ih l v ax
sinking|s ih ng k ih ng
sixteen|s ih k s t iy n
size|s ay z
sleeping|s l iy p ih ng
slices|s l ay s ih z
slid|s l ih d
slush|s l ah sh
small|s m ao l
smoky|s m ow k iy
smooth|s m uw dh
snowed|s n ow d
snow|s n ow
sock|s oh k
soft|s oh f t
soldiers|s ow l jh ax z
sold|s ow l d
source|s ao s
spring|s p r ih ng
square|s k w ea
squirrel|s k w ih r ax l
stain|s t ey n
stalled|s t ao l d
start|s t aa t
state|s t ey t
steady|s t eh d iy
steps|s t eh p s
stockings|s t oh k ih ng z
stone|s t ow n
stop|s t oh p
store|s t ao
storm|s t ao m
straight|s t r ey t
strained|s t r ey n d
stray|s t r ey
street|s t r iy t
strive|s t r ay v
strokes|s t r ow k s
strongly|s t r oh ng l iy
struck|s t r ah k
stunned|s t ah n d
stupid|s t y uw p ih d
sugar|sh uh g ax
sums|s ah m z
sun|s ah n
swam|s w ae m
swan|s w oh n
sweet|s w iy t
take|t ey k
talked|t ao k t
tall|t ao l
tame|t ey m
tank|t ae ng k
task|t aa s k
tea|t iy
tell|t eh l
ten|t eh n
term|t er m
than|dh ae n
that|dh ae t
their|dh ea
there|dh ea
there|dh ea r
these|dh iy z
the|dh ax
the|dh iy
thick|th ih k
thin|th ih n
third|th er d
this|dh ih s
those|dh ow z
threw|th r uw
through|th r uw
thrown|th r ow n
tight|t ay t
tool|t uw l
too|t uw
torn|t ao n
town|t aw n
to|t ax
to|t uw
trash|t r ae sh
tried|t r ay d
truck|t r ah k
turned|t er n d
tusk|t ah s k
twisted|t w ih s t ih d
two|t uw
used|y uw z d
useless|y uw s l ax s
use|y uw z
us|ah s
verse|v er s
very|v eh r iy
vest|v eh s t
view|v y uw
wagon|w ae g ax n
walled|w ao l d
was|w ax z
water|w ao t ax
way|w ey
weeks|w iy k s
week|w iy k
well|w eh l
were|w er
we|w iy
what|w oh t
wheels|w iy l z
when|w eh n
while|w ay l
wide|w ay d
will|w ih l
winding|w ay n d ih ng
wipe|w ay p
wire|w ay ax
wisp|w ih s p
without|w ih dh aw t
with|w ih dh
woke|w ow k
woman|w uh m ax n
words|w er d z
work|w er k
worn|w ao n
wrist|r ih s t
write|r ay t
wrong|r oh ng
yacht|y oh t
year|y er
young|y ah ng
your|y ao
you|y uw
